"filename", "language", "Markdown", "C++", "Batch", "comment", "blank", "total"
"d:\Onedrive\DataStructClassDesign\build.cmd", "Batch", 0, 0, 1, 0, 0, 1
"d:\Onedrive\DataStructClassDesign\config.h.in", "C++", 0, 11, 0, 10, 4, 25
"d:\Onedrive\DataStructClassDesign\data\数据说明.md", "Markdown", 4, 0, 0, 7, 12, 23
"d:\Onedrive\DataStructClassDesign\docs\总体设计.md", "Markdown", 6, 0, 0, 0, 7, 13
"d:\Onedrive\DataStructClassDesign\docs\编码规范.md", "Markdown", 23, 0, 0, 0, 22, 45
"d:\Onedrive\DataStructClassDesign\docs\问题记录.md", "Markdown", 32, 0, 0, 7, 41, 80
"d:\Onedrive\DataStructClassDesign\include\hebeu_map.h", "C++", 0, 62, 0, 37, 24, 123
"d:\Onedrive\DataStructClassDesign\include\show.h", "C++", 0, 98, 0, 18, 21, 137
"d:\Onedrive\DataStructClassDesign\readme.md", "Markdown", 18, 0, 0, 7, 13, 38
"d:\Onedrive\DataStructClassDesign\src\algorithm.cpp", "C++", 0, 43, 0, 11, 4, 58
"d:\Onedrive\DataStructClassDesign\src\init.cpp", "C++", 0, 45, 0, 15, 8, 68
"d:\Onedrive\DataStructClassDesign\src\main.cpp", "C++", 0, 16, 0, 7, 2, 25
"d:\Onedrive\DataStructClassDesign\src\menu.cpp", "C++", 0, 74, 0, 11, 3, 88
"d:\Onedrive\DataStructClassDesign\src\show.cpp", "C++", 0, 56, 0, 14, 6, 76
"d:\Onedrive\DataStructClassDesign\src\welcome.cpp", "C++", 0, 19, 0, 14, 4, 37
"Total", "-", 83, 424, 1, 158, 171, 837